00 02 00 02 00 02 00 02 00 02 00 02 00 02 00 02 
00 00 02 00 02 00 02 00 02 00 02 00 02 00 02 00 
00 02 05 04 04 04 00 02 04 04 04 04 04 05 00 02 
05 05 05 03 03 03 02 00 03 03 03 03 03 06 02 00 
05 05 05 03 08 08 00 02 08 08 08 03 03 06 00 02 
02 00 10 06 02 00 02 00 02 00 02 10 03 06 02 00 
00 02 10 06 00 11 02 02 00 02 00 10 03 06 00 02 
02 00 10 06 02 09 02 00 02 00 02 10 03 06 02 00 
00 02 10 06 00 02 00 02 00 02 00 10 03 06 00 02 
02 00 10 03 04 04 04 05 02 00 02 09 08 07 02 00 
00 02 09 08 08 08 08 07 00 02 00 02 00 02 00 02 
02 00 02 00 02 00 02 00 02 00 02 00 02 00 02 00 