00 00 00 00 00 00 01 01 01 00 00 00 00 00 00 00 
00 00 00 00 00 00 02 02 02 00 00 00 00 00 00 00 
00 00 01 01 07 07 02 02 02 01 01 01 01 07 00 00 
01 07 07 07 07 07 02 02 02 07 07 07 07 07 00 00 
07 07 07 07 07 07 02 02 02 07 07 07 07 07 00 00 
07 07 07 07 07 07 02 02 02 07 07 07 07 07 00 00 
07 07 07 07 07 07 02 02 02 07 07 07 07 07 00 00 
07 07 07 07 07 07 02 02 02 07 07 07 07 07 00 00 
07 07 07 07 07 07 02 02 02 07 07 07 07 07 00 00 
07 07 10 03 04 01 02 02 02 01 07 07 07 07 00 00 
07 07 09 08 08 01 01 01 01 01 00 00 00 00 00 00 
00 00 00 00 00 00 01 00 00 00 00 00 00 00 00 00